      1,   2,   2,   2,   2,   2,   2,   0,   0,   2,   2,   2,   2,   2,   2,   2,   2,   2,   2,   3,
      5,   0,   0,   0,   0,   0,   0,   0,   0,   0,   0,   0,   0,   0,   0,   0,   0,   0,   0,   7,
      5,   0,   0,   0,   0,   0,   0,   0,   0,   0,   0,   0,   0,   0,   0,   0,   0,   0,   0,   7,
      5,   0,   0,   0,   0,   0,   0,   0,   0,   0,   0,   0,   0,   0,   0,   0,   0,   0,   0,   7,
      5,   0,   0,   0,   0,   0,   0,   0,   0,   0,   0,   1,   2,   2,   2,   2,   2,   2,   2,   4,
      5,   0,   0,   0,   0,   0,   0,   0,   0,   0,   0,   5,  15,   6,   6,   6,  14,   6,   6,   7,
      5,   0,   0,   0,   0,   0,   0,   0,   0,   0,   0,   5,   6,  14,   6,   6,   6,   6,   6,   7,
      5,   0,   0,   0,   0,   0,   0,   0,   0,   0,   0,   9,  10,  10,  10,  10,  10,  10,  10,   4,
      5,   0,   0,   0,   0,   0,   0,   1,   2,   2,   3,   0,   0,   0,   0,   0,   0,   0,   0,   7,
      5,   0,   0,   0,   0,   0,   0,   5,   6,   6,   7,   0,   0,   0,   0,   0,   0,   0,   0,   7,
      5,   0,   0,   0,   0,   0,   0,   5,  14,   6,   7,   0,   0,   0,   0,   0,   0,   0,   0,   7,
      5,   0,   0,   0,   0,   0,   0,   5,   6,  15,   7,   0,   0,   0,   0,   0,   0,   0,   0,   7,
      5,   0,   0,   0,   0,   0,   0,   9,  10,  10,  11,   0,   0,   0,   0,   0,   0,   0,   0,   7,
      5,   0,   0,   0,   0,   0,   0,   0,   0,   0,   0,   0,   0,   0,   0,   0,   0,   0,   0,   7,
      5,   0,   0,   0,   0,   0,   0,   0,   0,   0,   0,   0,   0,   0,   0,   0,   0,   0,   0,   7,
      8,   2,   3,   0,   0,   0,   0,   0,   1,   2,   2,   2,  13,   2,   0,   0,   2,   2,   2,   4,
      5,  14,   8,   0,   0,   2,  13,   2,   4,   0,   0,   0,   5,   0,   0,   0,   0,   0,   0,   7,
      5,   6,   5,   0,   0,   0,   5,  14,   7,   0,   0,   0,   5,   0,   0,   0,   0,   0,   0,   7,
      5,  15,   5,   0,   0,   0,   5,  14,   7,   0,   0,   0,   5,   0,   0,   0,   0,   0,   0,   7,
      5,   6,   5,   0,   0,   0,   9,  10,   4,   0,   0,   0,   8,   3,   0,   0,   0,   0,   0,   7,
      5,  15,   5,   0,   0,   0,   0,   0,   7,   0,   0,   0,   9,  12,  10,  10,   0,   0,  10,   4,
      5,   6,   5,   0,   0,   0,   0,   0,   7,   0,   0,   0,   0,   0,   0,   0,   0,   0,   0,   7,
      5,  14,   5,   0,   0,   0,   0,   0,   7,   0,   0,   0,   0,   0,   0,   0,   0,   0,   0,   7,
      8,  10,  12,  10,   0,   0,  10,  10,  11,   0,   0,   0,   1,   2,   2,   3,   0,   0,   0,   7,
      5,   0,   0,   0,   0,   0,   0,   0,   0,   0,   0,   0,   5,   6,  15,   7,   0,   0,   0,   7,
      5,   0,   0,   0,   0,   0,   0,   0,   0,   0,   0,   0,   5,  14,   6,   7,   0,   0,   0,   7,
      5,   0,   0,   0,   0,   0,   0,   0,   0,   0,   0,   0,   8,  10,  10,  11,   0,   0,   0,   7,
      5,   0,   0,   1,   2,   0,   0,   2,  13,   2,   2,   2,   4,   0,   0,   0,   0,   0,   0,   7,
      5,   0,   0,   5,   0,   0,   0,   0,   7,  15,   6,   6,   7,   0,   0,   0,   0,   0,   0,   7,
      5,   0,   0,   5,   0,   0,   0,   0,   7,   6,   6,   6,   9,   3,   0,   0,   0,   0,   0,   7,
      5,   0,   0,   5,   0,   0,   0,   0,   7,  15,   6,   6,   6,   8,   2,   0,   0,   2,   2,   4,
      5,   0,   0,   5,   0,   0,   0,   0,   7,   6,   6,   6,  15,   5,   0,   0,   0,   0,   0,   7,
      5,   0,   0,   5,   0,   0,   0,   0,   7,  15,   6,   6,   6,   5,   0,   0,   0,   0,   0,   7,
      5,   0,   0,   5,   0,   0,   0,   0,   7,   6,   6,   6,  15,   5,   0,   0,   0,   0,   0,   7,
      9,  10,  10,  12,  10,   0,   0,  10,  12,  10,  10,  10,  10,  12,  10,  10,  10,  10,  10,  11,



     18,  34,  34,  32,   2,  34,  34,  34,  34,  35,
     80,   0,   0,   0,   0,   0,   0,   0,   0,   7,
     80,   0,   0,   0,   0,   0,   0,   0,   0,   7,
     80,   0,   0,   0,   0,   0,   0,   0,   0,   7,
     80,   0,   0,   0,   0,   1,  34,  34,  34,  36,
     80,   0,   0,   0,   0,   5, 246, 102, 230, 103,
     80,   0,   0,   0,   0,   5, 110, 102, 102, 103,
     80,   0,   0,   0,   0,   9, 170, 170, 170, 164,
     80,   0,   0,   1,  34,  48,   0,   0,   0,   7,
     80,   0,   0,   5, 102, 112,   0,   0,   0,   7,
     80,   0,   0,   5, 230, 112,   0,   0,   0,   7,
     80,   0,   0,   5, 111, 112,   0,   0,   0,   7,
     80,   0,   0,   9, 170, 176,   0,   0,   0,   7,
     80,   0,   0,   0,   0,   0,   0,   0,   0,   7,
     80,   0,   0,   0,   0,   0,   0,   0,   0,   7,
    130,  48,   0,   0,  18,  34, 210,   0,  34,  36,
     94, 128,   2, 210,  64,   0,  80,   0,   0,   7,
     86,  80,   0,  94, 112,   0,  80,   0,   0,   7,
     95,  80,   0,  94, 112,   0,  80,   0,   0,   7,
     86,  80,   0, 154,  64,   0, 131,   0,   0,   7,
     95,  80,   0,   0, 112,   0, 156, 170,   0, 164,
     86,  80,   0,   0, 112,   0,   0,   0,   0,   7,
     94,  80,   0,   0, 112,   0,   0,   0,   0,   7,
    138, 202,   0, 170, 176,   0,  18,  35,   0,   7,
     80,   0,   0,   0,   0,   0,  86, 247,   0,   7,
     80,   0,   0,   0,   0,   0,  94, 103,   0,   7,
     80,   0,   0,   0,   0,   0, 138, 171,   0,   7,
     80,   1,  32,   2, 210,  34,  64,   0,   0,   7,
     80,   5,   0,   0, 127, 102, 112,   0,   0,   7,
     80,   5,   0,   0, 118, 102, 147,   0,   0,   7,
     80,   5,   0,   0, 127, 102, 104,  32,   2,  36,
     80,   5,   0,   0, 118, 102, 245,   0,   0,   7,
     80,   5,   0,   0, 127, 102, 101,   0,   0,   7,
     80,   5,   0,   0, 118, 102, 245,   0,   0,   7,
    154, 172, 160,  10, 202, 170, 172, 170, 170, 171,
